111111
10EC01
100001
100001
100C01
100C01
100001
100P01
100001
100011
1000C1
111111



