111111
1PEC01
100001
100001
100C01
100C01
100001
100001
100001
100011
10C1
1111



