111111111111
100000000001
100000000001
10000000C001
100C00000001
100C000C0001
10C000E00001
1000P000C001
100111000001
100111111111
100111111111
111111111111