1111111111111
1000000000001
10P00C01E0C01
1000000100001
1111111111111