11111111111111111
100P000000N000001
11000NC1111111111
10E00111110000001
1000N00111000N101
10C000000000011C1
11111111111111111