1111111111111111111
111111P011111111111
1111110C11111111111
1000C00000C0000C001
1000000000000000N01
1C0N00C00000C000001
1000C11111100000001
111111111111100C111
1111111111111E11111
1111111111111111111